sid-55-col-jstoras10	JSTOR Arts & Sciences X Archive
sid-55-col-jstoras11	JSTOR Arts & Sciences XI Archive
sid-55-col-jstoras12	JSTOR Arts & Sciences XII Archive
sid-55-col-jstoras13	JSTOR Arts & Sciences XIII Archive
sid-55-col-jstoras14	JSTOR Arts & Sciences XIV Archive
sid-55-col-jstoras15	JSTOR Arts & Sciences XV Archive
sid-55-col-jstoras1	JSTOR Arts & Sciences I Archive
sid-55-col-jstoras2	JSTOR Arts & Sciences II Archive
sid-55-col-jstoras3	JSTOR Arts & Sciences III Archive
sid-55-col-jstoras4	JSTOR Arts & Sciences IV Archive
sid-55-col-jstoras5	JSTOR Arts & Sciences V Archive
sid-55-col-jstoras6	JSTOR Arts & Sciences VI Archive
sid-55-col-jstoras7	JSTOR Arts & Sciences VII Archive
sid-55-col-jstoras8	JSTOR Arts & Sciences VIII Archive
sid-55-col-jstoras9	JSTOR Arts & Sciences IX Archive
sid-55-col-jstorbusiness1archive	JSTOR Business I Archive
sid-55-col-jstorbusiness2archive	JSTOR Business II Archive
sid-55-col-jstorbusiness3archive	JSTOR Business III Archive
sid-55-col-jstorbusiness4archive	JSTOR Business IV Archive
sid-55-col-jstorbusiness	JSTOR Business & Economics
sid-55-col-jstorfilm	JSTOR Film and Performing Arts
sid-55-col-jstorhealth	JSTOR Health & General Sciences
sid-55-col-jstoribero	JSTOR Iberoam√©rica
sid-55-col-jstorireland	JSTOR Ireland
sid-55-col-jstorlanguage	JSTOR Language & Literature Archive
sid-55-col-jstorlife	JSTOR Life Sciences Archive
sid-55-col-jstormaths	JSTOR Mathematics & Statistics
sid-55-col-jstormusic	JSTOR Music Archive
sid-55-col-jstorreligion	JSTOR Religion & Theology
sid-55-col-jstorsustain	JSTOR Sustainability
